
  SSSSSSSSSSSSSSSSSSSSSSSSSSSSSSSSSSSSSSSSSSSSSSSSSSSSSSSSSSSSSSSSSSSSSSSSSSSSSSSSSSSSSSSSSSSSSSSSSSSSSSSSSSSSS SSSSSSSSSSSSSSSSSSSSSSSSSSSSSSSSSSSSSSSSSSSSSSSSS
  SSSSSSSSSSSSSSSSSSSSSS             SSSSSSSSSSSSSSSSSSSSSSSSSSSSSSSSSSS        S       S        SSSSSSS                   SSSSS             SS                 S
  SSSSSSSSSSSSSSSSSSSSSS             SSSSSSSSSSSSSSSSSSSSSSSSSSSSSSSSSSS        4       4I       SSSSSSS                   SSSSS             SS                 S
                       S             SSSSSSSSSSSSSSSSSSSSSSSSSSSSSSSSSSS                                                                     SS                 S
                       4      L      4I          4I         4I     4I                                      C  C  C                                              S
SSS                                                                                                                                                             S
SSSS                                                                                                                                         X                  S
SSSSS                              SSSSSSSSSSSSSSSSSSSSSSSSSSSSSSSSSSSSS    4I      4I      4I            C  C  C                           5SSS                S
SSSSSSSSSSSSS  SSSSSSSSSSS   SSS   SSSSSSSSSSSSSSSSSSSSSSSSSSSSSSSSSSSSSSSSSSSSSSSSSSSSSSSSSSSSSSSSSSSSS            SSSS   SSSSS-------------SSS                S
SSSSSSSSSSSSS fSSSSSSSSSSS   SSS   SSSSSSSSSSSSSSSSSSSSSSSSSSSSSSSSSSSSSSSSSSSSSSSSSSSSSSSSSSSSSSSSSSSSS            SSSS   SSSSS             SSS                S
SSSSSSSSSSSSSTTSSSSSSSSSSS f SSS f SSSSSSSSSSSSSSSSSSSSSSSSSSSSSSSSSSSSSSSSSSSSSSSSSSSSSSSSSSSSSSSSSSSSS            SSSS   SSSSS     f       SSS          w     S
SSSSSSSSSSSSSttSSSSSSSSSSSTTTSSSTTTSSSSSSSSSSSSSSSSSSSSSSSSSSSSSSSSSSSSSSSSSSSSSSSSSSSSSSSSSSSSSSSSSSSSSSSSSSSSSSSSSSSSSSSSSSSSSTTTTTTTTTTTTTSSSSSSSSSSSSSSSSSSSS
SSSSSSSSSSSSSttSSSSSSSSSSStttSSStttSSSSSSSSSSSSSSSSSSSSSSSSSSSSSSSSSSSSSSSSSSSSSSSSSSSSSSSSSSSSSSSSSSSSSSSSSSSSSSSSSSSSSSSSSSSSStttttttttttttSSSSSSSSSSSSSSSSSSSS