
  SSSSSSSSSSSSSS                  SSSSSSSSSSSSSSSSSSSSSSSSSSSSSSSSSSSSSSSSSSSSSSSSS          SSSSSS                SSSSSSSSSSSSSSSSSSSSSSSSSSSSSSSSSSSSSSSSSSSSSSSSSSSSSSSSS
  SSSSSSSSSSSSSS       L          SSSSSSSSSSSSSSSSSSSSSSSSSSSSSSSSSSSSSSSSSSSSSSSSS          SSSSSS                SSSSSSSSSSSSS              SS                           S
  SSSSSSSSSSSSSS                  SSSSSSSSSSSSSSSSSSSSSSSSSSSSSSSSSSSSSSSSSSSSSSSSS          SSSSSS                SSSSSSSSSSSSS              SS                           S
                                  SSSSSSSSSSSSSSSSSSSSS4ISSSSSSSSSSSSSSSSSSSSSSSSSS                                             rrrrrr                                     S
                      S4S                                                         4I                                                                                       S
SSS                                                                                                                                                                        S
SSSS                                                                                                                                         X                             S
SSSSS             SS       SS        SSSSSSSSSSSS4ISSSSSSSSSS4ISSSSSSSSSS4I                                                                 5SS                            S
SSSSSSSSSSSSSSSS                SS                                              SSSS        4SSSSSS   iii   S  SS  SSSSS  SS  SS-------------SS                            S
SSSSSSSSSSSSSSSS                SS                                              SSSS        SSSSSSS    4    S  SS  SSSSS  SS  SS             SS                            S
SSSSSSSSSSSSSSSSf             f SS                                              SSSS        SSSSSSS   iii   S fSS fSSSSS  SS  SS   f  f      SS                  w         S
SSSSSSSSSSSSSSSSTTTTTTTTTTTTTTTTSSSSSSSSSSS4ISSSSSSSSSS4ISSSSSSSSSS4ISSSSSSSSSSSSSSS        SSSSSSSSSSSSSSSSSTTSSTTSSSSSSSSSSSSSTTTTTTTTTTTTTSSSSSSSSSSSSSSSSSSSSSSSSSSSSSSS
SSSSSSSSSSSSSSSSttttttttttttttttSSSSSSSSSSSSSSSSSSSSSSSSSSSSSSSSSSSSSSSSSSSSSSSSSSSS        SSSSSSSSSSSSSSSSSttSSttSSSSSSSSSSSSStttttttttttttSSSSSSSSSSSSSSSSSSSSSSSSSSSSSSS